  const mazes = [
            // Add more mazes if needed
            [
                ['S', '0', '0', '1', '0', '0', '1', '0', '0', '0'],
                ['1', '1', '0', '1', '0', '0', '0', '1', '1', '0'],
                ['0', '1', '0', '0', '0', '1', '0', '0', '0', '0'],
                ['0', '0', '1', '1', '0', '1', '0', '1', '1', '0'],
                ['0', '1', '0', '0', '0', '1', '0', '0', '0', '1'],
                ['1', '0', '1', '0', '1', '0', '1', '1', '0', '0'],
                ['0', '0', '1', '0', '0', '0', '0', '1', '1', '0'],
                ['0', '1', '0', '1', '1', '1', '0', '0', '0', '0'],
                ['0', '1', '0', '0', '0', '1', '0', '1', '1', '0'],
                ['0', '0', '0', '1', '0', '0', '0', '0', '0', 'E']
            ],
            [
                ['S', '0', '1', '1', '0', '1', '0', '1', '1', '1'],
                ['0', '0', '1', '1', '1', '1', '0', '0', '0', '1'],
                ['1', '0', '0', '1', '0', '1', '1', '1', '1', '0'],
                ['0', '0', '0', '1', '1', '0', '1', '0', '1', '0'],
                ['0', '1', '0', '0', '0', '0', '1', '1', '0', '1'],
                ['0', '1', '0', '0', '1', '0', '0', '1', '1', '0'],
                ['0', '0', '1', '0', '1', '0', '0', '1', '1', '1'],
                ['1', '0', '0', '1', '1', '0', '0', '0', '0', '1'],
                ['0', '1', '0', '0', '1', '1', '1', '1', '0', '0'],
                ['1', '1', '1', '0', '0', '0', '0', '0', '0', 'E'],
            ],
            [
                ['S', '0', '1', '1', '0', '0', '1', '0', '1', '0'],
                ['1', '0', '1', '1', '0', '1', '1', '1', '0', '1'],
                ['1', '0', '0', '0', '0', '1', '0', '0', '0', '1'],
                ['0', '0', '0', '1', '0', '1', '0', '1', '0', '0'],
                ['1', '0', '1', '1', '0', '1', '1', '1', '0', '1'],
                ['1', '0', '0', '1', '0', '0', '0', '0', '1', '0'],
                ['0', '0', '1', '0', '1', '0', '1', '0', '1', '1'],
                ['1', '0', '0', '0', '0', '0', '0', '0', '0', '0'],
                ['1', '1', '1', '1', '1', '1', '1', '0', '1', '0'],
                ['1', '1', '1', '0', '1', '1', '0', '0', '0' ,'E'],
            ],
            [
                ['S', '0', '1', '0', '0', '1', '0', '1', '0', '0'],
                ['0', '1', '0', '1', '0', '0', '1', '0', '1', '0'],
                ['1', '0', '0', '1', '0', '1', '0', '0', '1', '1'],
                ['0', '1', '1', '0', '0', '0', '1', '1', '0', '0'],
                ['0', '0', '1', '0', '1', '0', '0', '1', '0', '0'],
                ['1', '0', '0', '1', '0', '1', '0', '0', '1', '1'],
                ['0', '1', '1', '0', '0', '0', '1', '0', '0', '0'],
                ['0', '0', '1', '1', '1', '0', '0', '1', '0', '0'],
                ['1', '0', '0', '0', '1', '0', '1', '0', '0', '0'],
                ['0', '1', '0', '0', '0', '1', '0', '1', '1', 'E']
            ],
            [
                ['S', '0', '0', '1', '0', '0', '0', '1', '0', '0'],
                ['1', '1', '0', '0', '1', '0', '1', '0', '1', '1'],
                ['0', '0', '0', '1', '0', '1', '0', '0', '0', '0'],
                ['1', '1', '0', '0', '1', '0', '0', '1', '0', '0'],
                ['0', '0', '0', '0', '0', '0', '1', '0', '0', '0'],
                ['0', '1', '1', '1', '1', '0', '1', '1', '1', '0'],
                ['0', '1', '0', '0', '0', '0', '0', '0', '0', '1'],
                ['0', '0', '1', '0', '0', '1', '1', '0', '0', '0'],
                ['1', '0', '0', '0', '1', '0', '1', '0', '0', '0'],
                ['0', '1', '1', '0', '0', '0', '0', '0', '1', 'E']
            ],
            [
                ['S', '1', '0', '0', '0', '1', '0', '0', '0', '1'],
                ['0', '0', '0', '0', '1', '0', '1', '0', '0', '0'],
                ['0', '0', '0', '0', '0', '0', '1', '1', '0', '1'],
                ['1', '0', '1', '1', '1', '0', '0', '0', '1', '0'],
                ['0', '0', '0', '0', '0', '1', '0', '0', '1', '0'],
                ['0', '0', '1', '1', '0', '0', '1', '0', '0', '1'],
                ['1', '0', '0', '1', '1', '0', '1', '0', '0', '0'],
                ['0', '1', '0', '0', '0', '1', '0', '1', '0', '1'],
                ['0', '0', '0', '1', '0', '0', '0', '1', '0', '0'],
                ['1', '1', '1', '0', '0', '1', '0', '0', '0', 'E']
            ],
            [
                ['S', '0', '0', '1', '0', '0', '1', '0', '0', '0'],
                ['0', '1', '0', '1', '0', '0', '1', '1', '0', '1'],
                ['0', '0', '1', '0', '0', '1', '0', '0', '1', '0'],
                ['1', '0', '0', '1', '0', '0', '1', '0', '0', '0'],
                ['0', '1', '1', '0', '1', '0', '1', '0', '1', '0'],
                ['0', '0', '0', '1', '0', '1', '0', '0', '1', '1'],
                ['1', '1', '0', '0', '1', '0', '0', '1', '0', '0'],
                ['0', '0', '1', '0', '0', '0', '1', '0', '1', '0'],
                ['1', '0', '0', '1', '1', '0', '1', '0', '0', '0'],
                ['0', '0', '1', '0', '0', '1', '0', '1', '0', 'E']
            ],
            [
                ['S', '0', '1', '1', '0', '0', '0', '1', '0', '0'],
                ['1', '0', '0', '0', '1', '1', '0', '0', '1', '1'],
                ['0', '0', '1', '0', '1', '0', '1', '0', '0', '0'],
                ['0', '1', '0', '0', '0', '1', '1', '0', '1', '0'],
                ['1', '0', '0', '1', '0', '0', '1', '0', '0', '0'],
                ['0', '1', '0', '0', '1', '0', '0', '1', '1', '0'],
                ['1', '0', '1', '0', '0', '1', '0', '0', '1', '0'],
                ['0', '1', '0', '1', '0', '0', '1', '0', '0', '0'],
                ['0', '0', '1', '0', '1', '0', '0', '1', '1', '0'],
                ['0', '1', '0', '0', '0', '1', '0', '0', '0', 'E']
            ]

        ];
